%%%%%%%%%
%.%.. %.%
%.%  .%.%
%G %%%  %
%   P% .%
%  %%%G %
%.%  %%%%
%.%   ..%
%%%%%%%%%